1111111111111111111111111     1111111111111111
1000000000000000000000000     1000000000000001
1000000000000000000000001     1111111111111101
1000000000000000000000001111111000000000000001
1000000000000000000000000000001000000000000111
10000000000000000000000000000010000000000001
100000000000000P0000000011111110011111111111
1000000000000000000111111     1001
10000000000000000001          1001
1111100000000000000111111111111001
    100000000000000000000000000001
    100000000000000000000000000001
    111111111111111111111111111111