NO ./textures/bluestone.xpm
SO ./textures/colorstone.xpm
WE ./textures/greystone.xpm
EA ./textures/redbrick.xpm
F 117, 142, 79
C 135, 245, 251

11111111111111111111111111111111111111111111111
10000000000000000000000000000000000000000000011
10000000000000000000000000000001111111111111011
10000000000000000000000011111110000000000000011
10000000000000000000000000000010000000000001111
10000000000000000000000000000010000000000001111
100000000000000P0000000011111110011111111111111
10000000000000000000000000000000000000000000001
10000000000000000000000000000000000000000000001
10000000000000000000001000000000000000000000001
10000000000000000000000000000000000000000000001
10000000000010000000000010000000000000000000001
10000000000010000000000000000000000000000000001
10000000000010000000000000000100000000000000001
10000000000010000000001000000000000000000000001
10000000000010000000000000000000000000000000001
10000010000010000000000000000000000000000000001
10000000000010000000001000000000000000000000001
10000000000010000000000000000100000000000000001
10000000000010000000010000000100000000000000001
10000000000010000000000000000111100000000000001
10000000100000000000000000100000000000000000001
10000000000000010000000000000000000000000000001
10000000000000000000000000000000000000000000001
10000000000000000000000000000000000000000000001
11111000000000000001111111111110000000000000001
11111000000010000000000000000000000000000000001
11111000000000000000000000000000000000000000001
11111111111111111111111111111111111111111111111
