11111111111111111111111111111111111111111111111
10000000000000000000000000000000000000000000011
10000000000000000000000000000001111111111111011
10000000000000000000000011111110000000000000011
10000000000000000000000000000010000000000001111
10000000000000000000000000000010000000000001111
100000000000000P0000000011111110011111111111111
10000000000000000000000000000000000000000000001
10000000000000000000000000000000000000000000001
11111000000000000001111111111110000000000000001
11111000000000000000000000000000000000000000001
11111000000000000000000000000000000000000000001
11111111111111111111111111111111111111111111111
