R 1080 1024

NO ./textures/bluestone.xpm
SO ./textures/colorstone.xpm
WE ./textures/greystone.xpm
EA ./textures/redbrick.xpm

F 117, 142, 79
C 135, 245, 251

11111111111111
10000000000001
10000000000001
10000000000001
10000000000001
10000111000001
10000111000001
10000000000001
10000000000001
10000000000001
10000000000001
11111111111111